XXXXXXXXXXXXXXXXXXXXXXXXXXX
XQQQQTQGQQQTOQQXQQQGQTQQQQX
XTXXQXQXQXQXQXQXQXQXQXQXXQX
XQQQQXQQQXQXQXQTQXQQQXQXQQX
XQXXQXXXXXQXQXQXQXXXXXQXQXX
XQQXQQQQQTQXQXQXQQQQQQQXQQX
XXOXQXXXXXQXQMQXQXXXXXQXXOX
XQQXQXQGQXQQQXXXQXQGQXQQTQX
XQXXTXQXQXQXQXOXQXQXQXQXXQX
XQQQQQQQQQQXQQQXQQQQQQQQQQX
XXXXXXXXXXXXXXXXXXXXXXXXXXX