XXXXXXXXXXXXXXXXXXXXXXXXXXX
XOQQQQQQQQQQXQQOQQQQQQQQMQX
XQXXXXTXXXXTQQXXXXQXXXTXXQX
XQXXXXQQGQQQXXOQXXQXXXQXXQX
XQQQQQQXXXXQXXXQQQQTQQQQQQX
XQXXXXQXXXXQTGQQXXXQXXXQXXX
XQQQQQQQXXQQXXXTQQQOQQQQXXX
XGXXQXQXXXXQXXXQXXXQXXXQXXX
XQXXQTQXXXXQTQQQQQQQQQGQXXX
XQQQQXQQQQQQXXXXXXXXXXXXXXX
XXXXXXXXXXXXXXXXXXXXXXXXXXX