XXXXXXXXXXXXXXXXXXXXXXXXXXX
XQQQQQTQQQQXXQXXQQTQQQQQQQX
XQXQXGXQXXQQQMQQQXXQXGXQXQX
XQXXXQXQXQQXXXXXQQXQXQXXXQX
XQTQQQXQXTXXQXOXXQXQXQTQQQX
XXXQXXXQXQQQQQQQTQXQXXXQXXX
XQQOQQXQXQXXOXQXXQXQXQQOQQX
XTXXXQXGXQQXXXXXQQXGXQXXXQX
XQQQXXXQXXQQQQQQQXXTXXXQQQX
XQXQQQQQQQQXXQXXQQQQQQQQXQX
XXXXXXXXXXXXXXXXXXXXXXXXXXX